####ü#####
#    #   #
#  t     #
#        #
    #    #
#        #
#    #   #
# t      #
#    t   #
##########