##########
#d  #    #
#        #
#  #     #
#  #s#    
#  # #   #
#  # #   #
#  # #m  #
#  # #   #
##########