##########
#   v#####
#m s #####
###  #  ##
  # v#  f 
#d##   h##
# l  s####
####     #
#h       #
##########
