#### #####
##vt     #
#  #d #  #
#     v# #
#ft  #    
###  t   #
#l#      #
#l# #f # #
#m       #
##########
