##########
#  m     #
#        #
#        #
#    x   #
#        #
#        #
#        #
#        #
#### #####