##########
#        #
#    e   #
#        #
#         
#      #e#
#        #
#        #
#  e     #
##########