##########
#        #
# t   t  #
#        #
    #     
#        #
# t   t  #
#        #
#        #
##########