##########
#h  #    #
#        #
#  #     #
#  #s#    
#  # #   #
#  # #   #
#  # #m  #
#  # #   #
##########