#### #####
# d    s #
#     t  #
#        #
         #
#   t    #
#        #
#        #
#        #
##########