##########
#hh #  mm#
# #    # #
#        #
#p     #  
#  #     #
#      # #
##       #
#mm  #   #
#### #####
