#### #####
#        #
#        #
#    g   #
#         
#        #
#        #
#        #
#        #
#### #####
