##########
#   c    #
#        #
#        #
#         
#        #
#        #
# h      #
#     m  #
#### #####