##########
#  m   ###
#  ###   #
##s     ##
#    x   #
# #k ##  #
# #t  t h#
# #  #  ##
#df  f  d#
#### #####
