#### #####
#gg#kkkk #
#gt #### #
###      #
  ###### #
# ##hsd# #
# ####   #
# # v#   #
#    s  m#
##########
