#### #####
#  # #  s#
#  #   #k#
#  #####k#
      g#k#
#     ##k#
#  h    s#
#### #####
#mttddddm#
##########
