##########
#     s  #
#  s     #
#        #
         #
#        #
# v      #
#      s #
#        #
#### #####