##########
#  m   ###
#  ###   #
##      ##
#    x   #
# #  ##  #
# #      #
# #  #  ##
#        #
#### #####