##########
#ct f  #m#
#ph #  # #
##### d# #
         #
#  l  #t #
#     #t #
########v#
#kvk lfs #
#### #####
