##########
#        #
# h      #
#        #
         #
#  s   t #
#      t #
########s#
# v      #
#### #####