##########
#        #
#  s     #
#      t #
       t  
#      t #
#        #
#    d   #
#       h#
##########