#### #####
#    #####
#    #####
#    #####
# ##      
# ##  ####
# ##  ####
# ## s####
#     ####
##########