##########
#     s  #
#  l     #
#        #
         #
#        #
# v      #
#      l #
#        #
#### #####