##########
#  m     #
#        #
#        #
#    b   #
#        #
#        #
#        #
#        #
#### #####