##########
#   c    #
#        #
#      d #
#         
#        #
#        #
# h      #
#     m  #
#### #####