#### #####
####v  vg#
## ## ## #
#      #s#
# ##  t   
##### ####
##    f ##
#  ttt#  #
#h   ##gp#
#### #####
