#### #####
# v    s #
#     t  #
#        #
         #
#   t    #
#        #
#        #
#        #
##########