#### #####
#        #
#        #
#n   g   #
#         
#        #
#        #
#        #
#        #
#### #####
