#### #####
#l       #
#  #  #  #
#        #
#         
#    #   #
#k       #
#     #  #
# m      #
##########