#### #####
#h #     #
##k#####k#
# s #    #
  #k# ####
#k#k#  s #
#k#k#  # #
#k#k#### #
#m# ssss #
##########
