#### #####
#        #
# s  s   #
#        #
         #
#        #
#        #
#        #
#  v     #
##########