##########
#        #
#        #
#        #
#         
#   b    #
#        #
#        #
#        #
##########