##########
#   e    #
#        #
#        #
          
#        #
#        #
#     m  #
#  e     #
##########