##########
#   #    #
##       #
#       ##
#     #   
#  #z    #
#      # #
#        #
#hm#     #
##########