##########
#        #
# t  t   #
#        #
         #
#   v    #
#      t #
#        #
#m t     #
#### #####