##########
#     t  #
#  #     #
#        #
          
#        #
#        #
# t      #
#        #
##########