##########
#s# h   m#
#l# v### #
#l#  #h# #
  #   ##  
#l###d####
# #      #
# l      #
#l     mm#
##########
