#### #####
#        #
#  #  #  #
#        #
#         
#    #   #
#        #
#     #  #
# m      #
##########