##########
#        #
#        #
#        #
#         
#   z    #
#        #
#        #
#        #
##########