##########
#s# h    #
# # v    #
# #      #
  #       
# #  d   #
# #      #
#        #
#        #
##########