##########
#        #
# t  t   #
#        #
#         
#        #
#        #
#        #
#     t  #
##########