##########
# #  l# f#
# # #l#  #
# s #f#  #
  ###l#   
###  l#  #
#kkvkk#  #
#kk#df#  #
#gl#d lm #
##########
