#### #####
#    c   #
# ##  #  #
#   #  ###
#p   # #  
#hh ## # #
#hh #  # #
#   # ## #
#mmm#    #
##########
