#### #####
#        #
#        #
########s#
#      t #
#      t #
#        #
#        #
#        #
#### #####