#### #####
#        #
#        #
########d#
#     # k#
#     #kt#
#    ## ##
#d    #k #
#  # lk  #
#### #####
