##########
#     # s#
#     #  #
# s   #  #
      #   
#     #  #
#  v  #  #
#     #  #
#        #
##########