#### #####
#        #
#        #
#     l  #
         #
#        #
#   v    #
#        #
#        #
##########