##########
#s# h    #
# # v    #
# #      #
  #       
# #  v   #
# #      #
#        #
#        #
##########