##########
# s   d  #
# #  k#  #
# # #   k#
  #  t    
#d#   #  #
#m# # t ##
#m# t   m#
#h#     s#
##########
