##########
#   e    #
#        #
#        #
          
#        #
#        #
#        #
#  e     #
##########