#### #####
#    #  m#
# # #### #
# # # f  #
  # # # t#
###   #  #
#h ####t #
# t   t  #
#m  t   t#
##########
