#### #####
#c       #
##########
#        #
#        #
#  b     #
#        #
#        #
#        #
#### #####