#### #####
#c       #
#t########
#        #
#        #
#        #
#        #
#        #
#        #
#### #####