#### #####
#c       #
##########
##      ##
#   b#   #
# #      #
#   #    #
#      # #
#        #
#### #####