##########
####  k  #
#### ###s#
#### #h# #
     #m# #
#   ft # #
#  #g# # #
#  ###   #
#p   # # #
#### #####
