##########
#h v     #
#ttt     #
#        #
#         
#        #
#        #
#        #
#        #
#### #####