##########
#      m #
#        #
#        #
#        #
#        #
#        #
#        #
#       h#
##########