##########
# k #v mv#
# # s   ##
# k ###  #
      ##s#
##  #  l #
#m  #k ###
##k##  s #
#k  ## #m#
##########
