##########
# l     m#
#    s v #
#        #
         #
#        #
#    s   #
#      v #
# l     m#
##########