##########
#        #
# t q  t #
#        #
#         
#        #
#        #
# g      #
#      g #
#### #####