##########
#    #   #
## #q# t #
#  ### # #
# #    #  
# # ######
# # #    #
# g #    #
# #    g #
#### #####
