##########
#        #
# t    t #
#        #
#         
#        #
#        #
#        #
#        #
#### #####