#### #####
#        #
# v #v v #
#        #
# s s#    
#  #     #
# #g# ## #
##g #ttt##
#gllfl   #
##########
