##########
##h###mm##
#        #
#  # ##  #
#  #  #  #
#  #  #  #
#  ## #  #
#        #
##mm###h##
##########
